NO ./path_to_the_north_texture
SO ./path_to_the_south_texture
WE ./path_to_the_west_texture
EA ./path_to_the_east_texture


F 220,100,99
C 225,30,0

   1111111
   1000001
   1000001
1110000000111
1000000000001
1000001000001
100001 100001
10001   10001
100001 100001
1000001000001
1110000000111
   1000001
   1000001
   1000001
   1000001
   100N001
   1000001
   1111111