NO sprites/e_04.xpm
SO sprites/e_00.xpm
EA sprites/b_11.xpm
WE sprites/c_05.xpm


F 220,100,99
C 225,30,0

   1111111
   1000001
   1000001
1110000000111
1000000000001
1000001000001
1000011100001
1000200020001
1000011100001
1000001000001
1110000000111
   1000001
   1000001
   1000001
   1000001
   100N001
   1000001
    11111