NO ./path_to_the_north_texture
SO ./path_to_the_south_texture
WE ./path_to_the_west_texture
EA ./path_to_the_east_texture


F 220,100,99
C 225,30,0

11111111111111
11000000110001
1000N100000111
11000001110101
11110111111101
11111111111111