NO sprites/xpm/wall_clouds.xpm
SO sprites/xpm/wall_clouds.xpm
EA sprites/xpm/wall_clouds.xpm
WE sprites/xpm/wall_clouds.xpm


F 31,163,224
C sprites/xpm/stars.xpm

   1111111
   1000001
   1000001
1110000000111
1000000000001
1000002000001
1000012100001
1000200020001
1000012100001
1000002000001
1110000000111
   1000001
   100N001
   1000001
   1000001
   1000001
   1000001
    11111